#######################################
# Syntax Coloring Map For BRAINZY 
#######################################

#######################################
# Datatypes (KEYWORD1)
#######################################

BRAINZY	KEYWORD1		DATA_TYPE
WidgetSonar	KEYWORD1		DATA_TYPE
WidgetRGB	KEYWORD1		DATA_TYPE

#######################################
# Instances (KEYWORD2)
#######################################

Robby	KEYWORD2

SerialUSB	KEYWORD2
SerialBluetooth	KEYWORD2
SerialWifi	KEYWORD2
SerialEXT1	KEYWORD2
SerialEXT2	KEYWORD2

SD	KEYWORD2

Widgets	KEYWORD2

#######################################
# Methods and Functions (KEYWORD2)
#######################################

setMode	KEYWORD2
slaved	KEYWORD2
noSlaved	KEYWORD2

nameWrite	KEYWORD2
nameRead	KEYWORD2
serialNumber	KEYWORD2
firmwareVersion	KEYWORD2
sendAT	KEYWORD2

rightMotorWrite	KEYWORD2
leftMotorWrite	KEYWORD2
frontMotorWrite	KEYWORD2
speedWrite	KEYWORD2

leftMotorPositionRead	KEYWORD2
rightMotorPositionRead	KEYWORD2
frontMotorPositionRead	KEYWORD2
resetWheelAngularPositions	KEYWORD2
xPositionWrite	KEYWORD2
yPositionWrite	KEYWORD2
angularPositionWrite	KEYWORD2
xPositionRead	KEYWORD2
yPositionRead	KEYWORD2
angularPositionRead	KEYWORD2

voltageBattRead	KEYWORD2
voltageCell1Read	KEYWORD2
voltageCell2Read	KEYWORD2
voltageCell3Read	KEYWORD2
alarmBattOn	KEYWORD2
alarmBattOff	KEYWORD2
checkBattProcess	KEYWORD2

isButtonPressed	KEYWORD2
isButtonReleased	KEYWORD2
ledButtonBlink	KEYWORD2
ledButtonNoBlink	KEYWORD2
ledButtonOn	KEYWORD2
ledButtonOff	KEYWORD2
isLedButtonOn	KEYWORD2

ledBlink	KEYWORD2
ledNoBlink	KEYWORD2
ledOn	KEYWORD2
ledOff	KEYWORD2
isLedOn	KEYWORD2

playNote	KEYWORD2
playMelody	KEYWORD2
playFile	KEYWORD2
playMelodyProcess	KEYWORD2

stop	KEYWORD2
goTo	KEYWORD2
translate	KEYWORD2
pointTo	KEYWORD2
turn	KEYWORD2
#turnAround	KEYWORD2

isActionDone	KEYWORD2
waitActionDone	KEYWORD2

beginSD	KEYWORD2

distanceRead	KEYWORD2
#colorWrite	KEYWORD2

#######################################
# Constants (LITERAL1)
#######################################

DIFFERENTIAL	LITERAL1		RESERVED_WORD_2
OMNIDIRECTIONAL	LITERAL1		RESERVED_WORD_2

NOTE_c	LITERAL1		RESERVED_WORD_2
NOTE_cS	LITERAL1		RESERVED_WORD_2
NOTE_d	LITERAL1		RESERVED_WORD_2
NOTE_dS	LITERAL1		RESERVED_WORD_2
NOTE_e	LITERAL1		RESERVED_WORD_2
NOTE_f	LITERAL1		RESERVED_WORD_2
NOTE_fS	LITERAL1		RESERVED_WORD_2
NOTE_g	LITERAL1		RESERVED_WORD_2
NOTE_gS	LITERAL1		RESERVED_WORD_2
NOTE_a	LITERAL1		RESERVED_WORD_2
NOTE_aS	LITERAL1		RESERVED_WORD_2
NOTE_b	LITERAL1		RESERVED_WORD_2

WIDGET_PORT_1	LITERAL1		RESERVED_WORD_2
WIDGET_PORT_2	LITERAL1		RESERVED_WORD_2
WIDGET_PORT_3	LITERAL1		RESERVED_WORD_2
WIDGET_PORT_4	LITERAL1		RESERVED_WORD_2
WIDGET_PORT_5	LITERAL1		RESERVED_WORD_2
WIDGET_PORT_6	LITERAL1		RESERVED_WORD_2

#######################################
# BRAINZY Board pin names (LITERAL1)
#######################################

MOT1_1	LITERAL1		RESERVED_WORD_2
MOT1_2	LITERAL1		RESERVED_WORD_2
MOT2_1	LITERAL1		RESERVED_WORD_2
MOT2_2	LITERAL1		RESERVED_WORD_2
MOT3_1	LITERAL1		RESERVED_WORD_2
MOT3_2	LITERAL1		RESERVED_WORD_2

ENC1_A	LITERAL1		RESERVED_WORD_2
ENC1_B	LITERAL1		RESERVED_WORD_2
ENC2_A	LITERAL1		RESERVED_WORD_2
ENC2_B	LITERAL1		RESERVED_WORD_2
ENC3_A	LITERAL1		RESERVED_WORD_2
ENC3_B	LITERAL1		RESERVED_WORD_2

BATT1	LITERAL1		RESERVED_WORD_2
BATT2	LITERAL1		RESERVED_WORD_2
BATT3	LITERAL1		RESERVED_WORD_2

SPI_MOSI	LITERAL1		RESERVED_WORD_2
SPI_MISO	LITERAL1		RESERVED_WORD_2
SPI_SCK	LITERAL1		RESERVED_WORD_2
SPI_CS1	LITERAL1		RESERVED_WORD_2
SPI_CS2	LITERAL1		RESERVED_WORD_2
SPI_CS3	LITERAL1		RESERVED_WORD_2

I2C_SDA	LITERAL1		RESERVED_WORD_2
I2C_SCL	LITERAL1		RESERVED_WORD_2

EEPROM_SIZE	LITERAL1		RESERVED_WORD_2
BUILTIN_BUZZER	LITERAL1		RESERVED_WORD_2
BUILTIN_LED	LITERAL1		RESERVED_WORD_2
BUILTIN_LED_BTN	LITERAL1		RESERVED_WORD_2
BUILTIN_BTN	LITERAL1		RESERVED_WORD_2

D1	LITERAL1		RESERVED_WORD_2
D2	LITERAL1		RESERVED_WORD_2
D3	LITERAL1		RESERVED_WORD_2
D4	LITERAL1		RESERVED_WORD_2
D5	LITERAL1		RESERVED_WORD_2
D6	LITERAL1		RESERVED_WORD_2